111111111111111111111111
12   3                21
1111    1  21   11111111
1  1                  21
11111111 17   2 11111111
128  a          1   b721
1111117  2    111111  11
12              9 4   61
1111     17   111111  11
1  1            1     21
1111   1   21   11111111
12            5       21
111111111111111111111111


